#####
#+ +####
#oo    #
#po#   #
# +    #
########