########
#  +   #
#      #
#  o   #
#  p   #
########