########
#  +   #
#  ?   #
#  o   #
#  p   #
########